R 1450        1500
NO ./textures/eagle.xpm
SO ./textures/mossy.xpm
WE ./textures/greenlight.xpm
EA ./textures/pillar.xpm

S ./textures/barrel.xpm
F 220,100,0
C 225,30,0

        1111111111111111111111111
        1000000000110000000000001
        1011000001110000000000001
        1001000000000000000000001
111111111011000001110000000000001
100000000011000001110111111111111
11110111111111011100000010001
11110111111111011101010010001
11000000110101011100000000201
10001000000000001102000012221
100000000000000011010100000001
11000001110101011111011100N1011
11110111 1110101 1011110001001
11111111 1111111 1111111111111
